#title
name = Icy Cave
difficulty = 5
backgroundgradient = 50,100,140-60,60,70

#map

0:0:s:s:s:s:s:s:s:s:s:s:s:s:s:s:s:s:s:s:s:s:s:s:s:s:s:s:s:s:s:s:s:s:s:s:s:s:s:s:s:s:s:s:s:s:s:s:s:s:s:s:s:s:s:s:s:s:s:s:s:s:s:s:s:s:s:s:s:s:s:s:s:s:s:s:s:s:s:s:s:s:s:s:s:s:s:s:s:s:s:s:s:s:s:s:s:s:s:s
0:0:s:s:s:s:s:s:s:s:s:s:s:s:s:s:s:s:s:s:s:s:s:s:s:s:s:s:s:s:s:s:s:s:s:s:s:s:s:s:s:s:s:s:s:s:s:s:s:s:s:s:s:s:s:s:s:s:s:s:s:s:s:s:s:s:s:s:s:s:s:s:s:s:s:s:s:s:s:s:s:s:s:s:s:s:s:s:s:s:s:s:s:s:s:s:s:s:s:s
0:0:s:s:s:s:s:s:s:s:s:s:s:s:s:s:s:s:s:s:s:s:s:s:s:s:s:s:s:s:s:s:s:s:s:s:s:s:s:s:s:s:s:s:s:s:s:s:s:s:s:s:s:s:s:s:s:s:s:s:s:s:s:s:s:s:s:s:s:s:s:s:s:s:s:s:s:s:s:s:s:s:s:s:s:s:s:s:s:s:s:s:s:s:s:s:s:s:s:s
0:0:s:s:s:s:s:s:s:s:s:s:s:s:s:s:s:s:s:s:s:s:s:s:s:s:s:s:s:s:s:s:s:s:s:s:s:s:s:s:s:s:s:s:s:s:s:s:s:s:s:s:s:s:s:s:s:s:s:s:s:s:s:s:s:s:s:s:s:s:s:s:s:s:s:s:s:s:s:s:s:s:s:s:s:s:s:s:s:s:s:s:s:s:s:s:s:s:s:s
0:0:s:s:s:s:s:s:s:s:s:s:s:s:s:s:s:s:s:s:s:s:s:s:s:s:s:s:s:s:s:s:s:s:s:s:s:s:s:s:s:s:s:s:s:s:s:s:s:s:s:s:s:s:s:s:s:s:s:s:s:s:s:s:s:s:s:s:s:s:s:s:s:s:s:s:s:s:s:s:s:s:s:s:s:s:s:s:s:s:s:s:s:s:s:s:s:s:s:s
0:0:s:s:s:s:s:s:s:s:s:s:s:s:s:s:s:s:s:s:s:s:s:s:s:s:s:s:s:s:s:s:s:s:s:s:s:s:s:s:s:s:s:s:s:s:s:s:s:s:s:s:0:0:0:0:0:0:0:s:s:s:s:s:s:s:s:s:s:s:s:s:s:s:s:s:s:s:s:s:s:s:s:s:s:s:s:s:s:s:s:s:s:s:s:s:s:s:s:s
0:0:s:s:s:s:s:s:s:s:s:s:s:s:s:s:s:s:s:s:s:s:s:s:s:s:s:s:s:s:s:s:s:s:s:s:s:s:s:s:s:s:s:s:s:s:s:s:s:s:0:0:0:0:0:0:0:0:0:0:s:s:s:s:s:s:s:s:s:s:s:s:s:s:s:s:s:s:s:s:s:s:s:s:s:s:s:s:s:s:s:s:s:s:s:s:s:s:s:s
0:0:s:s:s:s:s:s:s:s:s:s:s:s:s:s:s:s:s:s:s:s:s:s:s:s:s:s:s:s:s:s:s:s:s:s:s:s:s:s:s:s:s:s:s:s:s:s:s:0:0:0:0:0:0:0:0:0:0:0:s:s:s:s:s:s:s:s:s:s:s:s:s:s:s:s:s:s:s:s:s:s:s:s:s:s:s:s:s:s:s:s:s:s:s:s:s:s:s:s
0:0:s:s:s:s:s:s:s:s:s:s:s:s:s:s:s:s:s:s:s:s:s:s:s:s:s:s:s:s:s:s:s:s:s:s:s:s:s:s:s:s:s:s:s:s:s:s:s:0:0:I:I:0:s:0:0:0:0:0:s:s:s:s:s:s:s:s:s:s:s:s:s:s:s:s:s:s:s:s:s:s:s:s:s:s:s:s:s:s:s:s:s:s:s:s:s:s:s:s
0:0:s:s:s:s:s:s:s:s:s:s:s:s:s:s:s:s:s:s:s:s:s:s:s:s:s:s:s:s:s:s:s:s:s:s:s:s:s:s:s:s:s:s:s:s:s:s:s:0:0:0:0:0:s:0:0:0:0:0:s:s:s:s:s:s:s:s:s:s:s:s:s:s:s:s:s:s:s:s:s:s:s:s:s:s:s:s:s:s:s:s:s:s:s:s:s:s:s:s
0:0:s:s:s:s:s:s:s:s:s:s:s:s:s:s:s:s:s:s:s:s:s:s:s:s:s:s:s:s:s:s:s:s:s:s:s:s:s:s:s:s:s:s:s:s:s:s:s:s:0:0:0:0:s:s:0:0:0:0:s:s:s:s:s:s:s:s:s:s:s:s:s:s:s:s:s:s:s:s:s:s:s:s:s:s:s:s:s:s:s:s:s:s:s:s:s:s:s:s
0:0:0:s:s:s:s:s:s:s:s:s:s:s:s:s:s:s:s:s:s:s:s:s:s:s:s:s:s:s:s:s:s:s:s:s:s:s:s:s:s:s:s:s:s:s:s:s:s:s:b:0:0:0:s:s:s:s:0:0:s:s:s:s:s:s:s:s:s:s:s:s:s:s:s:s:s:s:s:s:s:s:s:s:s:s:s:s:s:s:s:s:s:s:s:s:s:s:s:s
0:0:0:0:0:s:s:s:s:s:s:s:s:s:s:s:s:s:s:s:s:s:s:s:0:0:0:0:0:0:s:s:s:s:s:s:s:0:0:0:0:0:0:0:s:s:s:s:s:s:0:0:0:b:s:s:s:0:0:0:0:s:s:s:s:s:s:s:s:s:s:s:s:s:s:s:s:s:s:s:s:s:s:s:s:s:s:s:s:s:s:s:s:s:s:s:s:s:s:s
0:0:0:0:0:0:0:s:s:s:s:s:s:s:s:s:s:s:s:s:s:s:s:0:0:0:0:0:0:0:0:0:s:s:s:s:0:0:0:0:0:0:0:0:0:0:s:s:s:0:0:0:0:0:s:s:0:0:0:0:0:0:0:s:s:s:s:s:s:s:s:s:s:s:s:s:s:s:s:s:s:s:s:s:s:s:s:s:s:s:s:s:s:s:s:s:s:s:s:s
0:0:0:0:0:0:0:0:0:0:0:s:s:s:s:s:s:s:s:0:0:0:0:0:0:C:0:C:0:0:0:0:0:0:0:0:0:0:0:0:0:0:0:0:0:0:0:0:0:0:0:I:I:0:s:s:0:0:0:0:0:0:0:0:0:0:0:0:0:0:0:0:0:0:0:0:0:0:0:0:0:0:0:0:0:0:0:0:0:0:0:0:0:0:0:0:0:0:0:0
0:0:0:0:0:0:0:0:0:0:0:0:0:0:s:s:s:0:0:0:0:0:0:0:0:2:0:2:0:0:0:0:0:0:0:0:0:I:0:0:b:0:0:0:0:0:0:0:0:b:0:0:0:0:s:s:0:0:0:0:0:0:0:0:0:0:0:0:0:0:0:0:0:0:0:0:0:0:0:0:0:0:0:0:0:0:0:0:0:0:0:0:0:0:0:0:0:0:0:0
0:0:0:0:0:0:0:0:0:0:0:0:0:0:0:0:0:0:0:0:0:0:0:0:0:0:0:0:0:0:0:0:0:0:0:0:0:0:0:0:0:0:0:0:0:0:0:0:0:0:0:0:0:0:s:s:0:0:0:0:0:0:0:0:0:0:0:0:0:0:0:0:0:0:0:0:0:0:0:0:0:0:0:0:0:0:0:0:0:0:0:0:0:0:0:0:0:0:0:0
0:0:0:0:0:0:0:0:0:0:0:0:0:0:0:0:0:C:C:0:0:0:0:0:0:0:s:s:0:0:0:0:b:b:0:0:I:0:0:0:0:0:0:I:0:0:0:0:0:0:b:0:I:0:s:s:0:0:0:0:0:0:0:0:0:0:0:0:0:0:0:0:0:0:0:0:0:0:0:0:0:0:0:0:0:0:0:0:0:0:0:0:0:0:0:0:0:0:0:0
0:0:0:0:0:0:0:0:0:0:0:0:0:0:0:0:0:0:0:0:0:0:0:0:0:s:s:s:0:0:0:0:0:0:0:0:0:0:0:0:0:0:0:0:0:0:0:0:0:C:C:0:0:0:s:s:0:0:0:0:0:0:0:0:0:0:0:0:0:0:0:0:0:0:0:0:0:0:0:0:0:0:0:0:0:0:0:0:0:0:0:0:0:0:0:0:0:0:0:0
0:0:X:0:0:0:0:0:0:0:0:0:0:0:0:0:0:0:0:0:0:b:b:b:s:s:s:s:0:0:0:0:0:0:0:0:0:s:0:0:0:0:0:0:0:0:0:0:0:0:0:0:0:b:s:s:s:0:0:0:0:0:0:0:0:0:0:0:0:0:0:0:0:0:0:0:0:0:0:0:0:0:0:0:0:0:0:0:0:0:0:0:0:0:0:0:0:0:0:0
g:g:g:g:g:g:g:g:g:g:g:g:g:g:I:I:I:0:0:0:0:C:0:s:s:s:s:s:s:0:0:0:0:0:0:0:0:s:0:0:0:0:0:0:0:0:0:0:0:0:M:0:0:0:s:s:s:s:0:0:0:0:0:g:g:0:0:0:0:0:0:0:0:0:0:0:0:0:0:0:0:0:0:0:0:0:0:0:0:0:0:0:0:0:0:0:0:0:0:0
d:d:d:d:d:d:d:d:d:d:d:d:d:d:I:I:I:0:0:I:I:I:0:s:s:s:s:s:s:0:0:0:I:0:0:b:b:s:0:0:0:0:0:0:0:0:0:b:b:0:s:b:0:0:s:s:s:s:0:0:0:0:g:d:d:I:I:I:I:I:I:I:I:I:I:I:I:I:I:I:I:I:I:I:I:I:I:I:I:I:I:I:I:I:I:I:I:I:I:I
d:d:d:d:d:d:d:d:d:d:d:d:d:d:I:I:I:0:0:I:I:I:0:s:s:s:s:s:s:0:0:0:I:0:0:0:0:s:0:0:0:0:0:0:0:0:0:0:0:0:s:0:0:0:s:s:s:s:s:s:0:0:d:d:d:d:d:d:d:d:d:d:d:d:d:d:d:d:d:d:d:d:d:d:d:d:d:d:d:d:d:d:d:d:d:d:d:d:d:d