#title
name = Grassy Land
difficulty = 5
backgroundgradient = 0,220,220-102,178,255
backgroundpixmap = background1.png

#map

0:0:0:0:0:0:0:0:0:0:0:0:0:0:0:0:0:0:0:0:0:0:0:0:0:0:0:0:0:0:0:0:0:0:0:0:0:0:0:0:0:0:0:0:0:0:0:0:0:0:0:0:0:0:0:0:0:0:0:0:0:0:0:0:0:0:0:0:0:0:0:0:0:0:0:0:0:0:0:0:0:0:0:0:0:0:0:0:0:0:0:0:0:0:0:0:0:0:0:0
0:0:0:0:0:0:0:0:0:0:0:0:0:0:0:0:0:0:0:0:0:0:0:0:0:0:0:0:0:0:0:0:0:0:0:0:0:0:0:0:0:0:0:0:0:0:0:0:0:0:0:0:0:0:0:0:0:0:0:0:0:0:0:0:0:0:0:0:0:0:0:0:0:0:0:0:0:0:0:0:0:0:0:0:0:0:0:0:0:0:0:0:0:0:0:0:0:0:0:0
0:0:0:0:0:0:0:0:0:0:0:0:0:0:0:0:0:0:0:0:0:0:0:0:0:0:0:0:0:0:0:0:0:0:0:0:0:0:0:0:0:0:0:0:0:0:0:0:0:0:0:0:0:0:0:0:0:0:0:0:0:0:0:0:0:0:0:0:0:0:0:0:0:0:0:0:0:0:0:0:0:0:0:0:0:0:0:0:0:0:0:0:0:0:0:0:0:0:0:0
0:0:0:0:0:0:0:0:0:0:0:0:0:0:0:0:0:0:0:0:0:0:0:0:0:0:0:0:0:0:0:0:0:0:0:0:0:0:0:0:0:0:0:0:0:0:0:0:0:0:0:0:0:0:0:0:0:0:0:0:0:0:0:0:0:0:0:0:0:0:0:0:0:0:0:0:0:0:0:0:0:0:0:0:0:0:0:0:0:0:0:0:0:0:0:0:0:0:0:0
0:0:0:0:0:0:0:0:0:0:0:0:0:0:0:0:0:0:0:0:0:0:0:0:0:0:0:0:0:0:0:0:0:0:0:0:0:0:0:0:0:0:0:0:0:0:0:0:0:0:0:0:0:0:0:0:0:0:0:0:0:0:0:0:0:0:0:0:0:0:0:0:0:0:0:0:0:0:0:0:0:0:0:0:0:0:0:0:0:0:0:0:0:0:0:0:0:0:0:0
0:0:0:0:0:0:0:0:0:0:0:0:0:0:0:0:0:0:0:0:0:0:0:0:0:0:0:0:0:0:0:0:0:0:0:0:0:0:0:0:0:0:0:0:0:0:0:0:0:0:0:0:0:0:0:0:0:0:0:0:0:0:0:0:0:0:0:0:0:0:0:0:0:0:0:0:0:0:0:0:0:0:0:0:0:0:0:0:0:0:0:0:0:0:0:0:0:0:0:0
0:0:0:0:0:0:0:0:0:0:0:0:0:0:0:0:0:0:0:0:0:0:0:0:0:0:0:0:0:0:0:0:0:0:0:0:0:0:0:0:0:0:0:0:0:0:0:0:0:0:0:0:0:0:0:0:0:0:0:0:0:0:0:0:0:0:0:0:0:0:0:0:0:0:0:0:0:0:0:0:0:0:0:0:0:0:0:0:0:0:0:0:0:0:0:0:0:0:0:0
0:0:0:0:0:0:0:0:0:0:0:0:0:0:0:0:0:0:0:0:0:0:0:0:0:0:0:0:0:0:0:0:0:0:0:0:0:0:0:0:0:0:0:0:0:0:0:0:0:0:0:0:0:0:0:0:0:0:0:0:0:0:0:0:0:0:0:0:0:0:0:0:0:0:0:0:0:0:0:0:0:0:0:0:0:0:0:0:0:0:0:0:0:0:0:0:0:P:0:0
0:0:0:0:0:0:0:0:0:0:0:0:0:0:0:0:0:0:0:0:0:0:0:0:0:0:0:0:0:0:0:0:0:0:0:0:0:0:0:0:0:0:0:0:0:0:0:0:0:0:0:0:0:0:0:0:0:0:0:0:0:0:0:0:0:0:0:0:0:0:0:0:0:0:0:0:0:0:0:0:0:0:0:0:0:0:0:0:0:0:0:0:0:g:g:g:g:g:g:g
0:0:0:0:0:0:0:0:0:0:0:0:0:0:0:0:0:0:0:0:0:0:0:0:0:0:0:0:0:0:0:0:0:0:0:0:0:0:0:0:0:0:0:0:0:0:0:C:0:0:0:0:0:0:0:0:0:0:0:0:0:0:0:0:0:0:0:0:0:0:0:0:0:0:0:0:0:0:0:0:0:0:0:0:0:0:0:0:0:0:0:0:0:d:d:d:d:d:d:d
0:0:0:0:0:0:0:0:0:0:0:0:0:0:0:0:0:0:0:0:0:0:0:0:0:0:0:0:0:0:0:0:0:0:0:0:0:0:0:0:0:0:0:0:0:0:0:0:0:0:0:0:0:0:0:0:0:0:0:0:0:0:0:0:0:0:0:0:0:0:0:0:0:0:0:0:0:0:0:0:0:0:0:0:0:0:0:0:0:0:0:0:g:d:d:d:d:d:d:d
0:0:0:0:0:0:0:0:0:0:0:0:0:0:0:0:0:0:0:0:0:0:0:0:0:0:0:0:0:0:0:0:0:0:0:0:0:0:0:0:0:0:0:0:0:0:0:&:0:0:0:0:0:0:0:0:0:0:0:0:0:0:0:0:0:0:0:0:0:0:0:0:0:0:0:0:0:0:0:0:0:0:0:0:0:0:0:0:0:M:0:0:0:1:0:d:d:d:d:d
0:0:0:0:0:0:0:0:0:0:0:0:0:0:0:0:0:0:0:0:0:0:0:C:C:0:0:0:0:0:0:0:0:0:0:0:0:0:C:C:0:0:0:0:0:g:g:g:g:g:0:0:0:0:0:0:0:0:0:0:0:0:0:0:0:0:0:0:0:0:0:0:0:0:0:0:0:0:0:0:0:0:0:0:0:0:0:g:g:g:g:g:g:g:g:d:d:d:d:d
0:0:0:0:0:0:0:0:0:0:0:0:0:0:0:0:0:0:C:0:0:0:0:0:0:0:0:0:0:0:0:0:0:0:0:0:0:0:0:0:0:0:0:0:b:d:d:d:d:d:g:0:0:0:0:0:0:0:0:0:0:0:0:0:0:0:0:0:0:0:0:0:0:0:0:0:0:0:0:0:0:0:0:0:0:b:0:d:d:d:d:d:d:s:s:s:s:s:s:s
0:0:0:0:0:0:0:0:0:0:0:0:0:0:0:0:0:0:b:0:0:0:0:0:0:0:0:0:0:C:0:0:0:0:0:0:0:0:0:0:0:g:0:0:0:d:d:d:d:d:d:0:0:0:0:0:0:0:0:0:0:0:0:0:0:0:0:0:0:0:0:0:0:0:0:0:0:0:0:0:0:0:0:0:0:0:0:d:s:s:s:s:s:s:s:s:s:s:s:s
0:0:0:0:0:0:0:0:0:0:0:0:0:0:0:0:0:0:0:0:0:0:b:0:0:b:0:0:0:0:0:0:0:0:0:0:0:b:M:M:b:d:0:0:0:d:d:d:d:d:d:g:0:0:0:0:0:0:0:0:0:0:0:0:0:0:0:0:0:0:0:C:0:0:0:C:0:0:0:0:0:0:0:0:0:0:s:s:s:s:0:0:0:2:0:0:0:s:s:s
0:0:0:0:0:0:0:0:0:0:0:C:0:0:0:b:b:b:0:0:0:0:0:0:0:b:b:0:0:0:0:0:0:0:0:0:g:g:g:g:g:d:1:1:1:d:d:d:d:d:d:d:0:0:0:0:0:0:0:0:0:b:0:0:b:0:0:b:0:0:0:0:0:0:0:0:0:0:0:0:0:0:0:0:0:s:s:0:C:0:0:0:C:0:0:2:0:0:0:s
0:0:0:0:0:0:0:0:0:0:b:b:b:0:0:0:0:0:0:0:0:0:0:0:0:b:b:b:0:0:0:0:0:0:0:g:d:d:d:d:d:d:g:g:g:d:d:d:d:d:d:d:b:b:0:0:0:0:0:0:0:0:0:0:0:0:0:0:0:0:0:0:0:0:0:0:0:0:0:0:0:0:0:0:0:0:0:0:0:0:0:0:0:0:0:0:0:C:C:s
0:X:0:0:0:0:0:0:0:0:0:0:0:0:0:0:0:0:0:b:0:0:0:C:0:b:b:b:0:0:0:1:0:0:g:d:d:d:d:d:d:d:d:d:d:d:d:d:d:d:d:d:b:b:0:0:0:0:0:b:0:0:C:0:C:0:C:0:0:b:0:1:0:b:0:0:0:b:0:0:0:0:0:0:b:0:0:0:M:0:0:0:M:0:0:0:0:C:C:s
0:0:0:0:0:0:0:0:0:0:0:0:0:0:0:0:0:0:b:b:0:0:1:C:0:g:g:g:g:g:g:g:g:g:d:d:d:d:d:d:d:d:d:d:d:d:d:d:d:d:d:d:g:g:g:1:0:0:g:g:0:1:0:1:0:1:0:1:0:g:g:g:g:g:M:M:M:g:g:0:0:0:0:0:b:0:0:s:s:s:s:s:s:s:s:M:M:s:s:s
g:g:g:g:g:g:g:g:g:g:g:g:g:g:g:g:g:g:g:g:g:g:g:g:g:d:d:d:d:d:d:d:d:d:d:d:d:d:d:d:d:d:d:d:d:d:d:d:d:d:d:d:d:d:d:g:g:g:d:d:g:g:g:g:g:g:g:g:g:d:d:d:d:d:s:s:s:d:d:g:g:g:g:g:g:g:s:s:s:s:s:s:s:s:s:s:s:s:s:s
d:d:d:d:d:d:d:d:d:d:d:d:d:d:d:d:d:d:d:d:d:d:d:d:d:d:d:d:d:d:d:d:d:d:d:d:d:d:d:d:d:d:d:d:d:d:d:d:d:d:d:d:d:d:d:d:d:d:d:d:d:d:d:d:d:d:d:d:d:d:d:d:d:d:d:d:d:d:d:d:d:d:d:d:d:d:s:s:s:s:s:s:s:s:s:s:s:s:s:s
d:d:d:d:d:d:d:d:d:d:d:d:d:d:d:d:d:d:d:d:d:d:d:d:d:d:d:d:d:d:d:d:d:d:d:d:d:d:d:d:d:d:d:d:d:d:d:d:d:d:d:d:d:d:d:d:d:d:d:d:d:d:d:d:d:d:d:d:d:d:d:d:d:d:d:d:d:d:d:d:d:d:d:d:d:d:s:s:s:s:s:s:s:s:s:s:s:s:s:s


